1111111111111
10C00C0C00CC1
1P0E11E00E001
1111111111111