1111111111111
10000C00000C1
1P0011E000001
1111111111111