111111111111111111111111111
10010000000C000100000000001
100000010000000000001000001
100000E1000C000100001000001
10010000000C000100000000001
100000010000000000001000001
10P00001000C000100001000001
10010000000C000100000000001
100000010000000000001000001
10000001000C000100001000001
111111111111111111111111111



